####################################################################################################
##..##....[][]..[][]......[]....[][]....##..........[]........##[][]..##........##....[][]........##
##[]....[]............[]##......[]..........##....[][]....[]........[]......[][]####[]....[]##....##
####..[]..[]......[]..##..[]......[]##[]......[]..##[]....##....##........##[]..[]..[][][]......####
######......[]......[]..[][]....[][]........[]..................[][]....[][]....##....[]......##[]##
##[][][][][]......[]..[][]..[]....[][]..[]..........[]..[]......[][]....[]##............[]..[]..####
##....##....##....####..[][][]..##[]....[]........................................[]##..[]....##..##
##..........[]..[]..[]..[][]....##..##..[]......[][][]..[]..##..................[]..##............##
##................##........[]....[]..[][][]..[][][]....[]......[]..[]..[][][]..[]......[]..[]..[]##
##....[]....[]................[]....[]##......[]..[]........##....[]............[]....[]..##[]....##
##[]........[]..[]......[]..................##......##..........[][]........[]............[][][][]##
##....[]..........[][][]##[]....[]..[]..##..........................[]..##[][]........[][]..[]..[]##
##......[][]..........##........[][]............[]##....[][][]........[]..[]....##[][]............##
##........[]##..............[]........##..##..[]....##..[][]##[]....[]......[][]....##[]##[]....[]##
##....[]....[]..................[]....##..[][]..##[]............[][]..[][]............[]......##..##
##..............................##......##..##......[]##........................[]..............[]##
##[][]......[]..[][][][]##[]..........[]................[][]..[][][]..[][]........[][]##..##......##
##..[]..##[]....[][]..[][]....[]....##....##....##....[]......[][][][]......................[]##..##
##......[][]............[]......[]....[]......[]..[]..[]##....[][][]............[]##....[]........##
####....[][]........[][]..........##..[]......[]....[][]..[]..[]....[]####....[]........##........##
##............[]......[]........##[][]....##..[][]..[]..[]..[]..##..[][]......[]........[][]..##..##
####..........##..[][]..[]..........................##[]............[][][]##....................[]##
##..................[]......##[][]..........##..........[]....##..........[][]..[]..##[]..........##
##..................##[]......[][]....[]......##..[][][]............[]........[]......[]..[]..##..##
##........[]....##......[][]..[][][]............@.....##....[]..[]....[]..[]..............##[]..[]##
##..[][]..##[]..[]....##....[]..............[][]..........##..[]..[]......####[]..............##..##
##....[]........[]..[]..........##..[]..[][]....[]......##[][][]..[]......[][]..[]....##..........##
##..##..[]..[][]..##......[]..........##......[]##..[]....##[]##[]..[][]........................####
##........##..[]........[]....[]......[][]......................[]..[]..[][]..[]..[][]....##..[]..##
##[]....[]..[]..[]..[][][]..[]....[]......##[]..[]....[][][]..[]##[]......##..[]......[][]..[]..[]##
##[][]........##..........[]..[]....##..##..[]..[]....................[][]..##....[]##............##
##....[]............[]##....[]......####[]..[]....[]..[]..##......[]..[][]..[]........[]....[]....##
##..##....[]..[]..........##[]..[]......[][][][]........[]##[]..[][]##........[]............[][][]##
####....##......[][]######..[]....[]..[][][]..[]..[]..................##....[]....[]..[]....[]....##
####......[][][][][]..[][][][]##....[]####......[]..........[]..[]....[][]........[][][]##........##
##........[]..[]....[][]....##[]....##......[]................[][][]..[]..####..[]..##..####....[]##
##..........[][]....[][]....[]......##..........[]..............##....................[]..##..##[]##
####....##..........##..[]......[]##....[]..........##..........##....##......[][]........[]......##
##..[][]......[]..[][]....##[]##......##......[]..[]..####....[]....##[]##..................[]....##
##............[]..[]....[]..[][]..##..[]..[]....[]......[][][]........##..[]..[][]..[]....[]......##
##....##......[]......[]....[][][]............................[]..##......[]....[]........[]..######
##................[][][]......[]....##..........[][]......[][]........[]............##..[][][]##[]##
##..####..[][]....[]..........####..[][]..[][]..##..[]..####....##....................[][]........##
##....[]..[]....[]..[]..##..[][][]......##........[]....##....##..[]..[]........##..[]....[]....####
##[]....[]....[]....[]..[]..........................[][][]..[]....[]....[]....[]....[]..[][]####..##
##......[]##[][]....[][]......[]..........[]....##[]..[]......[]......[]..[][]......[][]..........##
##....[]......##....##..[]........##..........##..[][][]##................[]..........##..[]......##
##..[][]......[][][][]..........##[]............##..........[]....[]..[]..[]..##..................##
##..........[]..[]##..[]....[][]............[]....[]..[]..[]........####[]##....[]..##......##....##
####################################################################################################